#separator:tab
#html:true
#tags column:3
Cry me a river&nbsp;	Llora todo lo que quieras. Deja de quejarte&nbsp;	
To Sink to a new level	Caer mas bajo	
Miscreants	Malvado/criminal (adjetivo) , malhechor/villano(sustantivo)	
Reign	Reinar, reinado(tiempo que se reina)	
Thankless	Ingrato&nbsp;	
Maneuver	Maniobra	
Reliable		
Opponent		
Employ		
Downtime&nbsp;	Tiempo de descanso, tiempo de inactividad&nbsp;	
Stepmother	Madrastra	
He introduced his current and ex-girlfriend at the party&nbsp;	Presentó a su novia actual y a su ex novia en la fiesta	
Toss a few down	Beber un trago rapido	
Mar	Estropear	
Dwindle	Ir desapareciendo, ir disminuyendo&nbsp;	
Dissatisfied	Descontento	
Leach	Extraer usando solución quimica &nbsp;	
Cannibalize	Canibalizar	
Uncall for		
Peril	Peligro&nbsp;	
Monopoly	Monopolio	
Stack	Pila/monton organizado, apilar/amontonar ordenadamente	
Mutt	Chucho&nbsp;	
the likes of	Alguien/gente/cosas/algo como	
Nick	Corte pequeño, rasguño o marca, cortar ligeramente, raspar	
Dent	Abolladura,abollar	
Gloss		
Inhospitable		
Hospitable		
Pop		
Pop up		
Pop off		
Jinx	"
“Jinx” se usa como una especie de “hechizo” o “maleficio” amistoso, como si decir algo al mismo tiempo causara una coincidencia especial. La palabra “jinx” en sí significa un tipo de mala suerte o maleficio, pero en este contexto es más una broma o superstición divertida entre amigos."	
Pick apart	Analizar minuciosamente para encontrar errores, criticar duramente , desmontar&nbsp;	
Freak	Friki/rareza(cosa o persona rara), obseso, extraño(adjetivo)	
Freak of nature	&nbsp;Rareza de la naturaleza&nbsp;	
Freak out		
Prattle	Parlotear/balbucear como niño, parloteo/balbuceo (de cosas sin importancia )	
Jolly	Alegre	
Hog	Cerdo, acaparar	
Slither	Reptar	
Dotar		
Puzzle	Desconcertar/confundir, puzzle, rompecabezas, misterio&nbsp;	
Random		
Randomly		
Ripen	Madurar	
Crusty		
Look to		
Dunk		
Floss		
Pump		
Pump up		
Pinpoint	Milimetrico/muy exacto, puntito, precisar	
Block out		
Canopy	Dosel, cubierta	
Compose		
Imitate		
Ludicrous	Ridiculo	
Pissant		
Budge	Mover/Moverse (se usa en negativo como que algo no puede moverse o ser movido), ceder	
Signify	Significar	
Ironclad	Acorazado, inquebrantable (en sentido figurado)	
Timid	Timido	
Ranger	Guardabosques, guarda forestal&nbsp;	
Subjugate	Subyugar	
Unrefined	Sin refinar	
Refine	Refinar, perfeccionar&nbsp;	
Denote	Denotar	
Embodiment	Representación/encarnacion	
Senescence	Envejecimiento	
Senescent	Envejecido	
Inevitability	Inevitabilidad	
Oomph	Entusiasmo	
Flush out	hacer salir	
Flashy	Llamativo	
Defense		
Presumptive	Presunto	
Presumptuous	Presuntuoso	
Foul	Asqueroso, horrible, falta, cometer falta, ensuciar	
Drop		
Drop by		
Make of	Opinar de, entender de, aprovechar de	
Make off	Huir/escaparse/irse	
Surgical		
Complication		
Scale		
Pollution		
Pneumonia		
Publish		
Investigational	De investigación&nbsp;	
Erect		
By no means	De ninguna manera&nbsp;	
Disturbance	Interrupción/molestia, altercado	
Captivate		
Irony		
Harp on (about)	Insistir. Hacer una con sbout y otra sin	
Harp about	Hablar mucho de	
Notion		
Timidity	Timidez	
Mimic		
Mimicking		
Pale		
Supreme	Supremo	
Exposure		
Stand to reason&nbsp;	Ser logico que&nbsp;	
Shameful	Vergonzoso&nbsp;	
Gossip	Cotilleo, cotilla, cotillear	
Rumor	Rumor	
Tousle	Despeinar	
Seethe	hervir, hervir de rabia, bullir&nbsp;	
Shake up	Revolucionar, conmocionar, reestructuración&nbsp;	
Botch	Fastidiar/estropear, chapuza	
Nowhere near	Ni de lejos	
Stricken	Afligido, afectado,	
Fake out	Engañar, despistar, engaño	
Peculiar		
Clear-cut	Claro/a	
Ulterior	Secreto/oculto. Ulterior motive/reason/purpose,..	
Sustain	Mantener en el tiempo, sustentar, sufrir, apoyar emocionalmente&nbsp;	
Legion		
Futile	Inútil&nbsp;	
Demise	Desaparicion	
Inescapable	Inevitable	
Pack on	Ganar peso o musculo, añadir	
Positive	Positivo, seguro	
Swat	Manotazo, dar un manotazo (principalmente para matar insectos)	
Swatter	Matamoscas	
Wagon	Carro/carruaje	
Furthermore	Ademas	
Obtuse	Obtuso	
Goose	Oca, ganso, idiota	
Goosebumps	Piel de gallina	
Bump		
Outhouse	Un baño exterior con agujero en vez de tuberías&nbsp;	
Squishy	Blando al presionar&nbsp;	
Fearless	Intrépido/valiente&nbsp;	
Monstrous	Monstruoso	
One-sided	Desigual	
Fill someone in on	Poner al corriente&nbsp;	
Diffuse	Difundir/se, esparcir/se, difuso	
Brutish	Brutal	
Pin		
Needle		
Dissect		
Bruiser		
By all means	Por supuesto&nbsp;	
How very touching&nbsp;	Que tierno/que conmovedor&nbsp;	
Unfathomable	Incomprensible&nbsp;	
Fathomable	Comprensible&nbsp;	
Reliance	Dependencia	
Rich	Ironico, rico	
Depraved	Depravado	
Depravity	Depravacion	
It’s niether just nor virtuous to live in peace and let the dead go anavenged	No es ni justo ni virtuoso vivir en paz y dejar a los muertos sin vengar	
Sore		
Sore loser		
Virtuous	Virtuoso	
Sickening	Repugnante	
Sickeningly	Repugnantemente&nbsp;	
Fruitless	Infructuoso	
UnObstruct		
Obstructive		
Note	Nota, notar,..	
Notice		
Retch	Dar arcadas	
Outweigh	Tener mas peso que/ superar/ ser mayor que&nbsp;	
Enslave	Esclavizar	
Evaporate		
Terror		
Slim		
Tether	Cadena, soga, amarrar, atar	
Faze	Perturbar, desconcertar&nbsp;	
Safeguard	Proteger, salvaguardar, salvaguarda	
Outthink	Pensar mejor&nbsp;	
Impulse		
Deficiency		
Oppose		
Distinct	Claro, diferenciado, distinto&nbsp;	
Faculty		
Remorse	Remordimiento	
Char	Carbonizar, carbonizarse, carbón(formado después de quemar algo)	
Catalyst	Catalizador	
Compulsion	Compulsion, obligacion	
Spot-on	Muy preciso	
Indication		
Regarding that	Respecto a eso	
Meantime		
Cover		
Nosy	Entrometido&nbsp;	
Counter	Contrarrestar	
Unearth	Sacar a la luz/descubrir, encontrar algo oculto enterrado o escondido&nbsp;	
Dormant	Aletargado/inactivo	
Tussle		
Haunt	Atormentar, frecuentar, lugar frecuentado, presencia fantasmal, encantado/frecuentado con espiritus	
Slat		
Icicle		
Second lease	Segunda oportunidad&nbsp;	
New lease	Nueva oportunidad&nbsp;	
Inconceivable	Inconcebible	
Sabotage	Sabotaje, Sabotajear	
Unsettle	Desconcertar/desestabilizar/perturbar/ inquietar	
Hang onto		
Poet		
Throw back	Echar en cara&nbsp;	
Venture	Aventurarse/atreverse, empresa arriesgada, aventura	
Fold	Doblar, cruzar partes del cuerpo, incorporar ingredientes, rendirse/cesar operaciones, pliegue, refugio de animales, grupo/ comunidad al que se pertenece, multiplo	
Pass along/across/through	Pasar a través/a lo largo de	
Blockbuster	Exito de taquilla/ventas	
Multiplex	Cine con muchas salas	
Revenue	Ingresos	
Tap into	Aprovechar algo para conseguir algo bueno&nbsp;	
Calamity		
Rope in	Arrastrar/enganchar a alguien (a unirse a algo)	
Gung-ho	Motivado, entusiasmado&nbsp;	
Shoot	Moverse rapido como una bala, brote de planta, filmar, tomar foto, mirar mostrando una emoción	
Shot	Tiro/lanzamiento, un intento de hacer algo, foto, toma (de una pelicula), chupito, destrozado, inyección	
Drag down	Arrastrar hacia abajo, desanimar/hundir emocionalmente, hundir/arrastrar (algo o alguien a una situación negativa)	
Mincemeat	Carne picada&nbsp;	
Veto	Veto, vetar&nbsp;	
Maid	Sirvienta	
Dorky	De Nerd, poco cool	
Gofer	Recadero	
Cosmic		
Desperate		
Sinner	Pecador	
Heinous	Atroz	
Bowel		
Trickery		
Embed		
Fall short		
Compatriot		
Take a load off	Relajate/sientate	
Pedestal		
Hurl	Arrojar con fuerza y violencia, soltar/lanzar (muchas cosas negativas a alguien hablando)	
Skew	Torcer, torcido&nbsp;	
Realm		
Run-down	Deteriorado, agotado, atropellar	
Low	El minimo (nivel de algo), deprimido, mugir, bajo, escaso,…	
Subside		
Rip out	Arrancar	
Hand out	Repartir/distribuir a gente	
Syllable		
Stack up		
Eject	Expulsar	
Wimp out	Rajarse/acobardarse	
Sleep-deprived	Privado de sueño&nbsp;	
Ink up		
The short end of the stick	La peor parte	
Mellow out	Relajarse mas	
Mellow		
Jab	Hincar/pinchar, dar a alguien con algo con punta aunque no este afilada (codazo, un dedo), dar un puñetazo en boxeo, golpe rapido, vacuna,&nbsp;	
Ease	Aliviar, facilidad, at ease(a gusto), mover con cuidado&nbsp;	
Make a stand	Plantarse/tomar una postura firme	
Worthiness&nbsp;	Valia	
Squabble	Reñir, riña (pelea sobre algo sin importancia)	
When it comes down to it&nbsp;	En el fondo	
Soak	Remojarse/empaparse, baño	
Stand your ground	Mantente firme&nbsp;	
Chickpeas	Garbanzos	
Pantry	Despensa	
Shack	Choza/casucha/chabola	
Think out	Planear/tramar/idear	
Inn		
Hostess&nbsp;	anfitriona	
Tray		
Playful	Chistoso	
Let go	Soltar, despedir	
Half-hearted	Desanimado&nbsp;	
Wear down	Desgastarse de hacer algo repetidamente, erosionar&nbsp;	
Close in	Acercarse	
Tide someone over	Ayudar a superar a alguien un momento difícil&nbsp;	
Jerky	Brusco, carne seca y curada, idiota	
Numb	Entumecido, insensible&nbsp;	
Gouge	Cavar o hacer hendiduras profundamente, cobrar excesivamente, hendidura o marca profunda,	
Gouge out	Sacar algo de una superficie haciendo una hendidura&nbsp;	
Latent		
Grow out	Crecer hacia fuera(his hair’s grown out)	
Grow out of		
Miraculous	Milagroso	
Spineless	Cobarde, invertebrado	
Tranquil		
Come to think of it&nbsp;	Ahora que lo pienso&nbsp;	
Cold shoulder	Tratar con indiferencia/ ser frio	
Hesitant	Indeciso, titubeante, vacilante&nbsp;	
Comical		
Keepsake	Recuerdo	
Clean break	Ruptura limpia	
Memento	Recuerdo	
Wear off	Dejar de hacer efecto	
It’s time to fish or cut bait	Es hora de decidirse o abandonar&nbsp;	
Slime	Liquido baboso, fango	
Turn on	Encender, excitar, algo excitante, volverse en contra	
Blurt	Soltar (decir sin pensar)	
Blurt out	Soltar algo (sin pensar)	
Think through	Pensar bien algo/sopesar	
Latrine	Letrina	
Husky	De voz ronca	
Pointy	Puntiagudo	
Play along	Seguir la corriente, participar en juego o broma, acompañar con un instrumento&nbsp;	
Demote	Degradar/bajar de categoría&nbsp;	
Drudge	Trabajador (de trabajo duro, monotono o tarease serviles) , trabajar arduamente&nbsp;	
Topple	Caerse, volcar, derribar/derrocar(del poder)	
Vulgar	Vulgar	
Crude	Burdo, grosero, bruto/tosco,	
Combatant	Combatiente	
Meager	Escaso	
Kindle	Encender, despertar sentimientos o indeas	
Mart	Tienda	
Weird out	Incomodar o sentirse incómodo&nbsp;	
Turn over	Entregar algo o responsabilidad a otro grupo o persona, voltear, recostarse&nbsp;	
Off base	Equivocado	
Twit	Estúpido&nbsp;	
Erradicate		
Existence		
To Get to it	Ponerse manos a la obra&nbsp;	
Paperwork		
Leave	Permiso(sin trabajar)	
Camp out	Acampar	
Painstaking	Laborioso&nbsp;	
Lively	Animado	
Morale	Moral	
Ecstasy		
Cotton		
Intervene	Intervenir	
Mischief	Travesura	
Primate		
Category		
Gorilla		
Grimoire		
Saddle		
Saddle with		
Bothersome	Molesto	
Catastrophe		
Overexert		
Curb	Acera, contener algo no querido	
Frame	Incriminar&nbsp;	
<b>Mastermind</b>	Ser el cerebro de(planear y organizar), &nbsp;cerebro&nbsp;	
Throw off	Quitarse rapidamente (ropa), librarse/deshacerse de	
Storm	Entrar por la fuerza, ir disparado hecho una furia&nbsp;	
Gift-wrap	Envolver para regalo, envoltura para regalo&nbsp;	
Blockade	Bloqueo, bloquear&nbsp;	
Dispassionate	Desapasionado	
Remote		
Toy	Jugar, juguete, de juguete	
Dissapearence	Desaparición	
Snuff	Apagar llama cubriendola con algo	
Snuff out	Sofocar,apagar, matar a alguien&nbsp;	
Sniff	Oler, sorber mocos , olisqueo/inhalación para oler,	
Sniff out	Descubrir mediante olor	
Counterpart	Homologo/equivalente	
Work someone over	Dar una paliza	
Underling	Subordinado	
Stunt	Estrategia para captar atención , pirueta/acrobacia peligrosa, frenar crecimiento/desarrollo&nbsp;	
Jest	Decir una broma , una broma&nbsp;	
Unify		
Formulate		
Impostor		
Cram	Embutir/apiñar/meter a presión&nbsp;	
Oversee	Supervisar	
Unchecked	Descontrolado&nbsp;	
Cargar con(carga emocional), llevar consigo (algo)		
Goof off	Perder el tiempo, hacer el tonto	
Goof	Tonto, error, hacer el tonto, meter la pata	
Stare		
Stare down	Mirar fijamente hasta que alguien retroceda&nbsp;	
Stare down at	Mirar fijamente desde posición superior&nbsp;	
Tick		
Sneak up (on)		
Quibble	Discutir por pequeñeces	
Trascendent	Transcendente(por encima de los limites del conocimiento), mas importante&nbsp;	
Definite	Definitivo	
Red-handed	Con las manos en la masa(haciendo algo ilegal)	
Felony	Delito grave	
Dispute	Disputa, poner en duda	
Chamber		
Urge	Impulso, rogar/pedir con insistencia&nbsp;	
Essence		
Vicinity	Alrededores&nbsp;	
Time-consuming	Que lleva mucho tiempo&nbsp;	
Match up	Coincidir, ser similar , ser igual de bueno&nbsp;	
Cross over	Cruzar, pasar al otro lado (muerte o transcendencia espiritual), cambiar de grupo/ideologia, pasar a tener exito en otros ambitos/audiencias, fusionar generos	
Whim	Capricho/antojo	
Fed up with	Estar harto de	
Cold-hearted	Frio/insensible	
Weasel	Comadreja	
Wind down	Disiparse hasta desaparecer , desconectar después de un dia duro, reducir trabajo hasta dejar ee tener actividad&nbsp;	
Lengthy	Largo/extenso	
Wily	Astuto&nbsp;	
How did you phrase it?	Como lo dijiste/expresaste?	
Lech	Alguien Lascivo	
Lecher	Persona lujuriosa/lasciva	
Lecherous	Lascivo	
Mull over&nbsp;	Reflexionar sobre algo&nbsp;	
Rascal	Pillín/granuja	
Grievous	Grave/severo/de extrema gravedad&nbsp;	
Dimension		
Eyesore	Monstruosidad (desagradable a la vista)	
Misery		
Muddle	Confusion, confundir	
Oblivion	El olvido	
Consign	Consignar	
Unheard	No escuchado, ignorado	
Reprehensible	Inaceptable/censurable	
Sound	Sonido, sondar, sonar(parecer), fundamentado/seguro/solido, profundamente, volumen,&nbsp;	
Inherit	Heredar	
Dispense with	Prescindir de	
Understatement	Quedarse corto/eufemismo	
Relentlessly		
Mark		
Contrivance	Artimaña/estratagema, dispositivo/artilugio	
Contrive	Idearselas/ ingeniárselas para (crear algun artilugio de forma inusual), arreglar (organizar situacion de forma ingeniosa), lograr(que algo ocurra de forma ingeniosa)	
Strike back	Contraatacar	
Farce	Farsa	
Restrain	Contener, sujetar	
Peasant	Campesino	
Geezer		
Spout	Hablar mas de la cuenta, salir a chorro/escupir, boca/pitorro	
Get one’s second wind	Recobrar el aliento	
Prognosis	Pronostico(diagnóstico medico y lo que se espera de ello), pronostico(como forecast)	
Prognostication	Pronostico(diagnóstico medico y lo que se espera de ello), pronostico (como forecast)	
Diagnosis	Diagnostico medico	
Touch-and-go	Incierta/critica	
Sympathize	Empatizar, sentir afinidad/simpatizar	
Gang up	Confabularse&nbsp;	
Gang	Pandilla/banda	
Initiate		
Shut off	Apagar, cortar suministro&nbsp;	
Fairly	Bastante, justamente	
Scoop	Sacabolas/boleadora, mover algo con sacabolas/boleadora o util similar, recoger con un rapido movimiento (scoop up), exclusiva/primicia(the scoop), dosificador	
Expel	Expulsar	
Gamble	Apuesta, apostar, riesgo	
Signature	Firma,señal/patron, distintivo/caracteristico	
Shut down	Cerrar, apagar	
Flop	Caer, fracaso, dejarse caer, fracasar, caida	
Induct	Incorporar	
Invincible		
Rage	Enfurecerse, rabia/furia, entrar en colera(fly into a rage), muy popular/lo ultimo(all the rage)	
Reinforcement	Refuerzo	
Break down	Averiarse(maquina), fracasar(y no poder continuar), desmoronarse (emociones), desglosar(en partes para analizar), derribar, descomponerse&nbsp;	
Buck	Desafiar, ciervo macho, dollar, dar sacudidas(un caballo intentando tirar al jinete)	
Kid	Tomar el pelo/bromear, niño, cabrito	
Recruit	Recluta, reclutar	
Discharge	Baja/alta(permiso para irse), liberar/dar de baja/alta(permiso para irse), emisión/vertido(liquido/gas), secrecion(corporal),disparar(arma de fuego), emitir/verter(gases/liquidos)	
Imbue	Imbuir	
Tamper with&nbsp;	Manipular/toquetear/falsificar	
Cross out	Tachar	
Fatso	Gordo	
Chick	Chica, pollito&nbsp;	
Developer		
doppelganger	Cambiaformas	
Humongous	Enorme	
Bum out	Decepcionar, deprimir	
Perch	Posición elevada/pedestal, rama alta(para un ave posarse), posarse (en lugar elevado), colocar en lo alto&nbsp;	
Polar	Polar, polo opuesto(polar opposite)	
Small-fry	Sin importancia, don nadie (persona insignificante), pequeñez(cosa insignificante), niños	
Brawl	Pelea caotica y violenta, Pelear de forma caotica y violenta	
Frail	Fragil	
Time is of the essence	El tiempo es crucial/vital	
So-called		
Sorry excuse		
Makeshift	Improvisado	
Pardon	Indulto, indultar, perdon? (Para que te repitan)	
Pardon me	Perdon?( Para que te repitan), perdone (para pedir paso), perdoname (pedir disculpas por hacer algo poco educado)	
Vague	Vago(poco claro o definido)	
Liven up	Alegrar (algo), animar (alguien)	
Schoolwork	Trabajo escolar	
Freeload	Gorronear	
Distant	Distante	
For a change	Para variar	
Phantom	Fantasma&nbsp;	
Phantasm	Fantasma, ilusion, aparición&nbsp;	
Necktie		
Bowtie		
Homeboy/homegirl	Colega/Compi/amigo cercano	
Homey	Colega/compi, hogareño/acogedor	
Haul	Llevarse (algo o alguien a otro lugar por la fuerza), tirar de/arrastrar(algo pesado), transportar, alijo, trayecto , redada(cantidad de peces pescados en red)	
Freshwater	De agua dulce	
Chew out		
Fidget	Estar inquieto/nervioso	
Fidgety	Nervioso/inquieto	
Odds and ends	Restos,cosas sueltas&nbsp;	
Cagey	Reservado(secretista)	
Secretive	Reservado(secretista)	
Persuade	Convencer	
Hang on to	Aferrarse, conservar&nbsp;	
Give someone grief	Regañar/causar problemas&nbsp;	
Reflection	Reflejo, reflexión&nbsp;	
hull	cascara de fruta, pelar/quitar cascara	
Strait-laced	Mojigato	
Loathsome	Odioso/repugnante&nbsp;	
Loath	Reacio	
Fluster	Poner nervioso/desconcertar, nerviosismo/confusion	
Get ahold of / get hold of	Conseguir (algo), localizar (alguien), tomar el control de (alguien/algo)	
Grab/Take ahold of / grab/take hold of	Agarrarse a (algo/alguien)	
Exaggerate	Exagerar	
Tacky	Hortera, pegajoso	
Tack	Chincheta, clavar con chinchetas, rumbo(manera de hacer)	
Outstandingly		
Mud	Barro/lodo	
Pendant	Colgante	
Plushie	Peluche	
Permutation	Combinación, permutación&nbsp;	
Retribution	Represalia/castigo severo merecido&nbsp;	
Twinkle		
Scope out	Inspeccionar, analizar, echar un vistazo, (normalmente antes de tomar una decisión)	
Bookmark		
Overuse	Usar en exceso, uso excesivo&nbsp;	
Make into	Convertir	
Spank	Azotar	
Sober	Sobrio, serio, simple , sober up (despejarse de la borrachera)	
Recede	Retirarse, desvanecerse, tener entradas(en el pelo)	
Reference		
Enforcement	Aplicación	
Promenade	Paseo marítimo&nbsp;	
Prom	Paseo marítimo&nbsp;	
Seafront	Paseo marítimo	
Definitive		
Move past	Dejar atras, superar	
Get the hang of	Cogerle el truco	
From here on	De aquí en adelante	
From there on	De ahi en adelante&nbsp;	
Dense	Denso, estupido	
Chopper	Helicóptero, instrumento para cortar	
Pose	Representar/significar, preguntar, posar, hacerse el interesante/ presumir , pose	
Rathole	Ratonera	
Chip in	Intervenir/interrumpir, contribuir&nbsp;	
Take something up with someone&nbsp;	Quejarse de algo a alguien&nbsp;	
Theatrical	Teatral, en cines,	
Wait a sec		
He can’t help it	El no puede evitarlo	
Get past	Superar algo(emocionalmente o mentalmente), pasar (fisicamente lugar u obstáculo), convencer (de que alguien acepte algo)	
Crib	Cuna, choza(coloquial para nombrar cualquier sitio en el que viva alguien)	
Entertain	Entretener, recibir invitados	
Entertainment	Entretenimiento, recibimiento&nbsp;	
Entertainer	Artista&nbsp;	
Snotty	Con mocos&nbsp;	
Ravish	Violar	
Ravishing	Deslumbrante, encantador	
Painstakingly	Laboriosamente/meticulosamente	
Rack somebody’s brains	Romperse la cabeza&nbsp;	
Bulk	Tamaño/volumen, the bulk of(la mayor parte de), in bulk(a granel/en gran cantidad)	
Drench	Empapar	
Stranglehold	Dominio, monopolio	
Paranoid	Paranoico	
Brim with	Lleno de	
Stairway	Escaleras	
Tamper with	Manipular/toquetear/forzar	
Radical		
Jackpot		
Wear and tear	Desgaste	
Chandelier	Lampara de araña&nbsp;	
Blindside	Atacar por lado ciego&nbsp;	
Bottom line	Conclusion, balance final	
Innate		
Intrigue	Intrigar	
Dread		
Thud	Golpe seco/sordo, golpear produciendo sonido sordo	
Suture		
Stand up to	Hacer frente&nbsp;	
Prosecute		
trespass	Rntrar sin permiso, allanar	
Egg on	Incitar	
Tab		
Dupe	Engañar, ingenuo	
iron-willed		
Chitchat		
Hear out	Escuchar todo lo que tiene que decir alguien&nbsp;	
Spirit sth/sb (away,off,out)	alejar/sacar algo/alguien de un lugar secretamente	
Domain		
Nab		
Sulky	Malhumorado&nbsp;	
Medallion	Medallón	
Tentatively	Provisionalmente , indecisamente&nbsp;	
Imbalance	Desequilibrio&nbsp;	
Spell	Periodo, señalar	
Thus far	Hasta ahora (como so far)	
Every blow struck home&nbsp;	Cada golpe dio en el blanco.	
Repair		
Irreparable		
Irreparably		
Rebuff	Rechazar, negativa&nbsp;	
Wholy	Completamente&nbsp;	
Clobber	Dar una paliza	
Grotesque	Grotesco(extraño y desagradable)	
Impurity	Impureza	
Frighten		
Disuade	Disuadir	
Trooper	Soldado, agente&nbsp;	
I beg to differ	Discrepo	
Reckoning	Ajuste de cuentas, calculo	
Reckon	Creer, pensar, estimar, calcular&nbsp;	
Swine	Cerdo (tanto animal, como ofensivo)	
Bloodshed	Derramamiento de sangre&nbsp;	
Suss out	Descifrar, averiguar, descubrir&nbsp;	
Retrace	Volver sobre	
Thieve	Robar	
Impudent	Insolente	
Quitter	Rendido/cobarde	
Contempt	Desprecio	
Dryness	Sequedad, aridez	
Circulation		
Resort to	Recurrir	
Light-headed	Mareado	
Impend		
Incorregible		
Notify		
Tidings	Noticias/nuevas	
Namely	Especificamente/concretamente	
Strenuous	Agotador/extenuante	
Talkative	Hablador/charlatan	
Wrong (como verbo)	Tratar injustamente, hacer daño (de forma indebida)	
		
Delirious	Delirante&nbsp;	
Rejoice	Alegrarse/regocijarse	
Grovel	Humillarse, arrastrarse	
Hasty	Apresurado, veloz&nbsp;	
Encase	Encajar, recubrir (como en una caja)	
Color me	Me has dejado (impresionado, sorprendido, intrigado, feliz o cualquier otra emocion que quieras añadir)	
Offset	Compensar&nbsp;	
Subsume	Incluir, absorber, englobar&nbsp;	
Don	Ponerse ropa	
Cunning	Astuto	
Permeate	Impregnar, penetrar&nbsp;	
Chastise	Castigar, criticar duramente&nbsp;	
Entitle	Nombrar/poner titulo, autorizar/dar derecho a	
Innards	Visceras, mecanismo interno&nbsp;	
Copycat	De imitación, copion	
Wobbly	Tambaleante	
Slate	Estar programado (be slated), pizarra(material), pizarra (psra escribir) , lista	
Foresee		
Wedge	Cuña, tacones altos (wedges), gajo/porcion, meter a presion/calzar	
Tyrant		
Nimbly	Ágilmente&nbsp;	
Kaput	Estropeado	
Sadist	Sadico	
Morphine	Morfina	
Blather	Parlotear, palabrería&nbsp;	
Puppeteer	Marionetista	
Tinge	Tinte, matiz, dar un logro toque o matiz de	
Pit (verbo)	Enfrentar, quitar hueso o semilla de fruta, llenar de hoyos o marcas	
Slum	Barrio bajo/suburbio, tugurio/pocilga, rebajarse (slum it)	
Prosthetic	Ortopedico	
Effrontery	Descaro	
Hazy	Brumoso/neblinoso, confuso,difuso&nbsp;	
Haze	Neblina&nbsp;	
Goo	Porqueria/pringue (sustancia desagradable y pegajosa&nbsp;	
Flunky	Lacayo/esbirro, repetidor (en estudios)	
Ruthlessness	Crueldad	
Muzzle	Hocico, boca de pistola,poner bozal, amordazar(impedir expresarse)	
Hank	Madeja	
Coil	Rollo/bobina, enrollar	
Outlive	Sobrevivir a	
Tinker	Trastear/manipular, manitas	
Everlasting	Eterno/ interminable/ perpetuo&nbsp;	
Tremor	Temblor	
Jolt	Sacudida, sacudir	
Scramble	Mover/Trepar/subir rapidamente, gatear, codificar, pelearse para, carrera de motocross	
Egotist	Egotista	
Frankly	Francamente	
Deity	Deidad	
Stillness	Quietud/calma	
Give someone an Earful	Echar la bronca&nbsp;	
Fossil	Fosil	
Latch onto	Aferrarse	
Misfit	Inadaptado	
Pensive	Pensativo&nbsp;	
Whirr	Zumbar	
Dump	Dejar, verter/tirar, vertedero/basurero, cuchitril, dejar(relacion)	
Boggle	Quedar en shock	
Restraint	Restricción/limite, compostura/autocontrol	
Cityscape	Paisaje urbano&nbsp;	
Strip away		
Outrank	Superar en rango	
Foothold	Punto de apoyo para el pie	
It’s still a ways off	Todavía falta bastante (ways: distancia considerable)	
Engrave	Grabar	
Sacred		
Holy		
Chalice	Caliz	
Surplus	Excedente/sobrante	
Crummy	De mierda/asqueroso	
Sinful	Pecaminoso	
Out of commission	Fuera de servicio	
Comission		
Pulpy	Pulposo	
Lifeless	Sin vida	
Preservative	Conservante	
Shoddy	De mala calidad, mezquino	
Wallflower	Persona timida/calladito, alhelí&nbsp;	
Messenger	Mensajero	
Grievous	De extrema gravedad&nbsp;	
Petulant	De mal genio	
Glisten	Relucir/brillar (por estsr mojado o liso)	
Deleterious	Nocivo/perjudicial	
Darndest	mas raro/inusual, mas extremo, mas increíble&nbsp;	
Numbness	Entumecimiento&nbsp;	
Pituitary		
Token	Señal/simbolo, vale, ficha, simbólico	
Gawp	Mirar boquiabierto	
Gawk	Mirar boquiabierto&nbsp;	
Knucklehead	Idiota	
Knuckle	Nudillo	
Purify	Purificar	
Radiance	Resplandor	
Fault	Culpa, defecto,Fallo, criticar, falla	
Preciousness	Valor, ternura	
Offspring	Descendencia	
Thereafter	A partir de entonces&nbsp;	
Overjoyed	Contentisimo	
Salvage	Rescate, rescatar/recuperar	
Weed out	Descartar	
Weed	Mala hierba, cannabis, quitar mala hierba	
Cringe	Encogerse de miedo&nbsp;	
Outshine	Eclipsar/brillar mas que&nbsp;	
Immune	Inmune	
Watchful	Vigilante	
Screechy		
Streamline	Hacer mas aerodinámico	
Frosting	Glaseado	
Gelatin		
Goop	Pringue	
Curry favor	Ganarse el favor	
Curry	Cepillar o asear caballo con cepillo, curry (comida)	
Shovel	Pala, palear(coger con pala)	
Spade	Pala	
Commence	Comenzar	
Bounty	Generosidad/regalo	
Hellion	Diablillo/revoltoso/rebelde/alborotador	
Smite	Castigar/infligir sufrimiento, afectar emocionalmente/o de amor, golpear con fuerza&nbsp;	
Gimmick	Truco/ardid	
Mallet	Mazo	
Rubber	Goma/caucho	
Gobble		
Splatter	Salpicar	
Ghastly	Horrible	
Put up your dukes	Preparate a pelear(levanta los puños)	
Flagpole	Asta de bandera	
Iifelike	Realista, como si estuviera vivo	
Scuffle	Pelea, refriega	
Run-in	Enfrentamiento	
Chunky	Fornido, con trozos	
Chunkify	Hacer mas robusto, dividir en partes o secciones&nbsp;	
Slender	Esbelto	
Short-list	Lista de candidatos preseleccionados, preseleccionar	
Spiral		
Spiralize		
Lash out	Arremeter/abalanzarse sobre alguien, gastarse dinero en grandes cantidades&nbsp;	
Glob	Gota, pegote	
Clean slate	borron y cuenta nueva	
Lice	Piojos (plural de louse)	
Boner	Erección, error tonto&nbsp;	
Uptown	Fuera del centro/las afueras&nbsp;	
Pet peeve	Lo que mas molesta	
Peeve	Fastidiar,/molestar&nbsp;	
Skim	Pasar casi rozando, leer por encima , rozar sobre agua&nbsp;	
Shrink	Psiquiatra	
Stepdad		
Shiver	Escalofrio/temblor, temblar/tiritar	
One-up	Verbo: superar/aventajar, sustantivo: ventaja	
Booze	Bebida Alcohólica, beber alcohol&nbsp;	
Long	Desear/ansiar	
Slayer		
Pacemaker		
Call	Decisión	
Chagrin		
Chagrined		
Yeast	Levadura	
Yeast infection	Candidiasis	
Elicit	Provocar(reacción),obtener (información)	
Wade in	Meterse(hacer o decir algo sin pensar cuidadosamente )	
Wade	Vadear	
Hump	Joroba, montículo,esfuerzo difícil, cargar con esfuerzo, trabajar duro, follar	
Trough		
Snob		
Stirrup	Estribo de montar, estribo para poner tobillos en el ginecólogo&nbsp;	
Gyno	Ginecologo	
gynecologist	Ginecologo	
Footage		
Wry	De burla/ironico	
Drizzle	Llovizna, lloviznar, rociar, chorrito	
Felt	Fieltro	
Felt-pen	Rotulador	
Felt-tip	Rotulador, también felt-tip pen	
Brochure	Folleto	
Cheerleader	Animadora	
Snuggle		
Squander	Delpilfarrar	
Crotch	Entrepierna	
Factual	Basado en hechos reales	
Just shy of enough&nbsp;	Quedarse un poco corto, casi suficiente pero no del todo&nbsp;	
Sappy	Cursi, sensiblero, empalagoso&nbsp;	
Headlight	Faro de vehículo	
Plow	Arar, arado	
Busty	Pechugona	
Wave off	Despedirse al irse de un lugar	
Shellfish	Marisco	
Sledgehammer	Mazo	
Nightstand	Mesita de noche&nbsp;	
Resin	Resina	
Canny		
Butterscotch	Caramelo duro hecho de azúcar y mantequilla&nbsp;	
Textile	Textil	
Eunuch	Eunuco	
Tweed	Mezcla de lana	
Occupy	Ocupar, ocuparse	
Comatose	Comatoso	
Pamper	Mimar/consentir	
Threshold	Umbral,entrada	
Jeopardy	Riesgo, peligro	
Jeopardize	Poner en peligro, arriesgar&nbsp;	
Fudge		
Figment	Producto de imaginación	
Dispenser		
Pros and cons		
Sic on	Echar animal a alguien (ordenar que ataque)	
Empower		
Summarize		
Puddle	Charco	
Doozy	Cosa extraordinaria&nbsp;	
Gooey	Pegajoso&nbsp;	
Cavort	Retozar	
